1100000101
0111110010
1110010001
1010011010
0100101111
1011111101
1001111101
1100100111
1010001110
0110111001
0010101111
0100000101
1101100010
0000101010
1101000110
1011111001
0100101010
1100110001
1010101101
0100100111
0011110100
0110001001
0000000100
1010111110
1000111000
1010000111
1111101000
0011100101
1111010111
1000000101
0110011001
0010110010
1001110001
1010001101
0011100101
0111011011
0000010011
0110001010
0000000110
1010000111
1001101100
0001110100
