111111111111111111111111
11111000E00000E001111111
111111111CCCCCC111111111
1111111111P0000111111111
111111111111111111111111