11111111111
11C0P0E1001
111111111111
11111111111
