11111111111
11C0P0E1001
11111111111
