1100000101
0111110010
1110010001
1010011010
0100101111
1011111101
1001111101
1100100111
1010001111
0110111001
