1111111111
1111110011
1110010001
1010011011
1100101111
1011111101
1001111101
1100100111
1010P01111
1110111001
1010101111
1100000101
11011E0011
1000101011
1101000111
101C111001
1100101011
1100110001
1010101101
1100100111
1011110101
1110001001
1000000101
1010111111
1000111001
1010000111
1111101001
1011100101
1111010111
1000000101
1110011001
1010110011
1001110001
1010001101
1011100101
1111011011
1000010011
1110001011
1000000111
1010000111
1001101101
1111111111
